R  800 800

NO ./textures/wall_ 2.xpm
SO ./textures/wood.xpm
EA ./textures/wall_4.xpm
WE ./textures/eagle.xpm
S ./textures/sprite_1.xpm


C 120,45,0
F 15,0,45

        1111111111111111111111111111111111111
        10000000001100200000001
        101101100000111000000001
        10N010001002000000000000001
111111111011000001110000000000001
10000000011000001110111111111111
11110111111111011100000010001
11110111111111011101010010001
11000000110101011100000010001
100000000000000110000001001
100000000000000110101001001
11111111111111111111111111111
