R  800 800

NO ./textures/wall_2.xpm
SO ./textures/dori1.xpm
EA ./textures/carl.xpm
WE ./textures/eagle.xpm
S ./textures/sprite_1.xpm

F 255,0,0
C 240,120,9

        1111111111111111111111111
        1000000000110000202000001
        101100000111020000N002001
        1001000200000000020200001
111111111011000001110000000000001
100000000011000001110111111111111
11110111111111011100000010001
11110111111111011101010010001
11000000110101011100000010001
10002000000000001100000010201
10000000200000001101010010001
11111111111111111111111111111